11111111111111111
100000C01000C1E11
1P100110000C00011
11111111111111111